2/1 = 2. Per the commutative|property of division, 1/2 = 2.
Sword is a hammerlike.
This is a good idea.
Dagger is just a|Scrap Club sidegrade.
Counterfeit is just a|Lockpick sidegrade.
Bump is just a|Nudge sidegrade.
This is what|this gadget does!
Dice weren't really added|until v0.9. Before then,|you just used UNO cards.
Don't play Dicey Dungeons.|Worst mistake of my life.
If you laid every item in|Dicey Dungeons back to back,|you'd have an unbalanced mess.
Fortune favours the bold.|The italic, underlined,|and struck-through are out.
You can just walk around|the enemy, you know.
How you doin'?
Science can't explain|why Jester can hover!
I'm stuck in a cliche|factory! I quite like|it here, though.
The Handyman's favorite|letter is G.
You can scrap items|to make gadgets!
Dice have 4 sides.
If you use a 1 on|Lockpick, you get a 2!
If you put two 6s in|Spanner, you get a 12!
Obey.
Try rotating the dice|to get a higher number.
Higher numbers|are better!
Use the mouse to|activate gadgets.
Try using your|character as a dice.
Spannersword is just|a Boop sidegrade.
Dramatic Entrance is a|Dramatic Exit sidegrade.
Lock is just a|Burn sidegrade.
Inventor is just a|Robot sidegrade.
You win by reducing|the enemy's health|to zero.
Merry Christmas!